##########
##   # . #
# $      #
#        #
#        #
#        #
#        #
##       #
#@       #
##########