##########
#     .  #
#   ### ##
#   #    #
#   #  $ #
#   #    #
#   #    #
#  $ .#  #
#@  ##   #
##########
