#########
#@      #
#   $   #
#      .#
#########